{
  "q": 31,
  "2": 32,
  "w": 33,
  "3": 34,
  "e": 35,
  "r": 36,
  "5": 37,
  "t": 38,
  "6": 39,
  "y": 40,
  "7": 41,
  "u": 42,
  "i": 43
}
